7400000000000054545454545400000000000000
7400000000000000000000000000000000000000
7400000000000000000000000000000000000000
7400000000000000000000000000000000101111
7400000000000000000000000000000000202121
7400004142430000000000000000000000202121
7400000000000000000000004142430000202121
7400000000000000000000000000000000202121
7400000000000041424300000000000000202121
1112000000000000000000004444444444202121
2123111111111111111111111111111111242121

image image:terrain
sprite @4,4 sprite:hero (u32)0
sprite @18,2 sprite:box (u32)0
sprite @4,6 sprite:box (u32)0
sprite @13,5 sprite:box (u32)0
sprite @4,9 sprite:box (u32)0
sprite @4,8 sprite:box (u32)0
sprite @4,7 sprite:box (u32)0
