0000000000000000000000000000000000000000
0000000000000000000000000000000000000000
0000000000000000000000000000000000000000
0000000000000000000000000000000000000000
0000000000000000000000000000000000000000
0000000000000000000000000000000000000000
0000000000000000000000000000000000000000
0000000000000000000000000000000000000000
0000000000000000000000000000000000000000
0000000000000000000000000100000000000000
1111111111111111111111111111111111111111

image image:terrain
sprite @13,9 sprite:flower (u24)0 0x1d
sprite @9,1 sprite:title 0x00000000
sprite @4,9 sprite:hero (u32)0
