2121133131313131311413313131313131142121
2113320000000000002022000000000000301421
1332000000000000002022000000000000003014
2274000000000000003032000000000000006420
2274000000000000005454000000000000006420
2274000000000000000000000000000000006420
2274000000000000004444000000000000006420
2274000000000000001012000000000000006420
2312000000000000002022000000000000001024
2123120000000000002022000000000000102421
2121231111111111112423111111111111242121

image image:terrain
sprite @4,9 sprite:hero (u32)0
sprite @15,9 sprite:flower 0x0000001d
