2121212121211331313131313131313131313114
2121212121212200000000000000000000000020
2121212121212200000000000000000000000020
2121212121212200000000000000000000000020
2121212121212241424242424242424243000020
2121212121212200000000000000000000000020
1331313131313200000000000000000000000020
2200000000000000000000000000001012000020
2200000000000000000000000000002022000020
2311111111111244444444444444442023111124
2121212121212311111111111111112421212121

image image:terrain
sprite @8,3 sprite:hero (u32)0
sprite @2,8 sprite:flower 0x0000001e
sprite @16,5 sprite:box (u32)0
sprite @6,7 sprite:box (u32)0
sprite @6,8 sprite:box (u32)0
sprite @16,6 sprite:box (u32)0
