0000000000000020212121212121212121212121
0000000000000020212121212121212121212121
0000000000000020212121212121212121212121
0000000000000020212121133131313131313114
0000000000000020212121220000000000000020
1111120000000020212121220000000000000020
2121220000000030313131320000000000000020
2121220000000000000000000000000000000020
2121220000000000000000000000000010111124
2121231111111111111111111111111124212121
2121212121212121212121212121212121212121

image image:terrain
sprite @17,7 sprite:flower 0x0000001f
sprite @9,8 sprite:bear (u32)0
sprite @1,4 sprite:hero (u32)0
