0000000000000000000000000000000000000000
0000000000000000000000000000000000000000
0000000000641011111111111274000000000000
0000000000642021212121212274000000000000
0000000000642021212121212274000000000000
0000000000642021212121212274000000000000
0000000000642021212121212274000000000000
1111111111112421212121212274000000000000
2121212121212121212121212274000000000000
2121212121212121212121212311111111111111
2121212121212121212121212121212121212121

image image:terrain
sprite @2,6 sprite:hero (u32)0
sprite @7,1 sprite:bear (u32)0
sprite @16,8 sprite:flower 0x0000001e
sprite @18,8 sprite:flower 0x0000001f
