0000000000002021133131313131313131311421
0000000000002013325454545454545454543014
0000000000002022740000000000000000006420
1111127400642022740000000000000000006420
2121227400642022740064101111111274006420
2121227400643032740064201331313274006420
2121227400005454000064202274000000006420
2121227400000000000064202274000000006420
2121227400000000000064202274000000006420
2121231244444444444410242312441012441024
2121212311111111111124212123112423112421

image image:terrain
sprite @11,3 sprite:alien (u32)0
sprite @1,2 sprite:hero (u32)0
sprite @15,8 sprite:flower 0x0000001f
sprite @16,8 sprite:flower 0x0000001d
